6 6
WWWWWW
W....W
W....W
WM...W
W..D.W
WWWWWW