WWWWWW
WM...W
W..W.W
WWWW.W
W..D.W
WWWWWW